C111111111
111P111111
1000001111
1000001111
1000001111
1111E11C11
1111111111