111111111
1001C1E11
1001P1011
100CCC001
111111111