C11111111111
111P11111111
100000111111
111111111111
111111111111
1111111C1111
1111111111E1