111111111
1101E1011
100000011
1P0C00011
111111111