11111111
1001E101
10000001
1P0C0001
11111111
